Musim,Hari Kerja,Hari Libur,Jumlah Total,Pengguna Kasual,Pengguna Terdaftar,Label Penggunaan
1,0,0,125868,30255,95613,Low
1,0,1,11815,2145,9670,Low
1,1,0,333665,28222,305443,High
2,0,0,268339,99747,168592,High
2,0,1,19637,5946,13691,Low
2,1,0,630613,97829,532784,High
3,0,0,289225,98517,190708,High
3,0,1,22831,8828,14003,Low
3,1,0,749073,118746,630327,High
4,0,0,238402,65854,172548,Low
4,0,1,24152,5440,18712,Low
4,1,0,579059,58488,520571,High
